..*******.*******..
*.................*
*.**.***.*.***.**.*
*........*........*
*.**.*.*****.*.**.*
*....*.......*....*
****.***.*.***.****
****.*.......*.****
****.*.**.**.*.****
.......*...*.......
****.*.*****.*.****
****.*.......*.****
****.*.*****.*.****
*........*........*
*.**.***.*.***.**.*
*..*...........*..*
**.*.*.*****.*.*.**
*....*...*...*....*
*.******.*.******.*
*.................*
..*******.*******..