..*********************..
.........................
*.*..........*.*........*
*.*..........*.*........*
*.*****.****.*.*.*.***..*
*.*...*.*..*.*.*.*...*..*
*.*...*.*.**.*.*.*...*..*
*.*...*.*....*.*.*...*..*
*.*...*.****.*.*.*****..*
.........................
..*********************..